11111111
100P00011111
11111000E001
    1C000001
    11111111