111111101111111111111111
100E000000000C000000P001
111111111111111111111111