11111111111111111
1000C10000111P001
10101001000001001
1E100001101000001
11111111111111111