NO ./assets/wall.png
SO ./assets/wall.png
WE ./assets/wall.png
EA ./assets/wall.png

F 220,100,0
C 225,30,0

  11111111
110000000011
111111000001
1    1100001
1    1100001
111111000001
100000000001
1000000000N1
 1111111111
  10001001
  10001001
  10001001
  10001001
   111 11