NO ./assets/wall.png
SO ./assets/wall.png
WE ./assets/wall.png
EA ./assets/wall.png

F 220,100,0
C 225,30,0

11111
1N001
10G01
10001
 111