NO ./assets/wall.png
SO ./assets/wall.png
WE ./assets/wall.png
EA ./assets/wall.png

F 220,100,0
C 225,30,0

111111111111
1000000000001
10N0000000001
 111111001111
      1001
      1001
   1000001
   1000001
   1111111