111111111
100010001
10E010P01
100010001
111110001
100000001
10C000C01
100000001
111111111