111111
1C1E01
111001
1P00C1
111111