1111111
100D0E1
10CDC01
1P0D001
1111111