111111111111111
100000111000001
100E0000000C001
100001111100001
100P0000000C001
100000111000001
111111111111111