111111111
1P00C00C1
10E000001
100000001
1C00CDDD1
1000D0001
1000D0E01
1D00D0001
111111111