11111111111111111
1000C10000111P001
101010010000D1001
1E100001101000001
11111111111111111