11111111111
10000E00001
1P000C000P1
11111111111