NO ./assets/wall.png
SO ./assets/bricksx64.png
WE ./assets/wall.png
EA ./assets/bricksx64.png

F 220,100,0
C 225,30,0

                   1
                  111
                  101
                 10001
                1000001
      111      100000001
     10001    10000000001
     10001    10000000001
     10001   1000000000001
      101    1100000000011
      101     10000000001
    11101111111000000000111
    10000000000000000000001
    10000000001111111000001
    10000000001     1000001
    10000000001     1000001
    11111111111     1000001
                    1000001
      1111111111    100N001
      1000000001    1000001
      1111111111    1000001
                    1111111