111111111111111
1000C0000000001
100000000E00001
111111111111111