111111111111111111
100011110011110001
10P001110011100C01
100000110011000001
110000011110000011
111000001100000111
111100000000001111
111110000000011111
10001100CC00110001
10001100CC00110001
111110000000011111
111100000000001111
111000001100000111
110000011110000011
100000110011000001
10C001110011100E01
100011110011110001
111111111111111111